###############
#      @      #
#    b   b    #
# #         ###
# #    b    # #
# #    b    # #
# #    b  v # #
# #    b    # #
#a#    be   # #
###h   b    # #
#         r a #
#      *    b #
######   ######
#      x    o #
###############
